      #######
  ####       ####
 #       *       #
#                 #
#                 #
#        D        #
#                 #
#                %#
#                %#
# ~~~~            #
#~~~~             #
#                 #
#------     ------#
#     +  @  +     #
###################
